0000000000
0111111111
0100000101
0111011101
0101000001
0101110111
0001000100
0111110111
0001010100
0111010111
