0400000000000000000000000000000000000000000000000000000000000
0111111111110101111101111101010101011101110111010111110101110
0001010001010101010001000001010101010000010100010100000101000
0111011101011111011111111111111111110101110111111101011101010
0101000100000101000100000101010100000101000100000001010001010
0101110111110101110111010101010111111111111111111111110101010
0001000001000101010000010001010101000001010100000001000101010
0111110111010101011101111101010101011101010111111101010111110
0000010000010000010000010100000000010100010101010100010101010
0111111111111101010101010111110101010111010101010111111101010
0000010100010001000101000101010101010000000001000101010000010
0111110101011101111111111101011111011111011101110101011111010
0101000001000101000100000100000101010000010100000001010100000
0101110111111111010101110101111101111111110101011101010111010
0001010101000101010001010000000001010100000001010000000000010
0111010101011101111111010101111101010101010111111111110101010
0001000000000100000100000101000001010001010101000001000101010
0111011111111111110111011111010101010111010101110101111111110
0100000001000100010000000001010100000100010000010100000001000
0111010111011111011111111101010111011111111101011101111101110
0100010101010100010100000101010100010001000001010001000100000
0111010101010101110111010101111111111101011101111111010111110
0100010001010100000101010001010100000000010001000000010000010
0101111111010111110101110111010101111111111111111111111111010
0000010101000101000001000100010101010000000001010100010000000
0111110101011101110101011111010111011111111101010101111111110
0100010100010101010100010101000101010000000001000101010101010
0111010101110101011111110101011101011111110111011101010101010
0000000000000000000000000000000000000000000000000000000000000
0000000000000000000000000000000000000000000000000000000000000
