0000000000000000000000000000000000000000000000000000000000000
0000000000000000000000000000000000000000000000000000000000000
0101111101011101011101010111111111110111111101111111010101010
0100010001000101000101010100000100010000010000000100010101010
0111110111110111011101011101011101011111110111111111110111010
0001000000010001000101000001000101000000010000000001010001010
0101110111011101111101010111111101110101011111011111010101010
0101000001000100000101010000000001010101010000000000010101010
0101111111010111110101111101011111011101011101011111010101110
0100000100010100010100010001000000000101010001000100010100010
0111111101111111011101111101111101011111111101011111010101010
0001000100000100010100010000000101000100010001010000010101010
0111010111011101110111010101111101010101110101011111110101110
0000010101000000000001010100000101010000010101000100000101000
0111111101111111111111111111111111111101110101111111011111110
0101000000000000000000000000000000000100010100000100000001000
0101010111011111110101110101011101111111011111010101011101110
0000010001000101010100010101010100000001000101010101000101000
0101111101010101011111010101010111111111110101110101010101010
0100000101010000010001010101000001010001000001010101010101010
0111111111111101111101011101110111011101011101011101111111110
0001000101010100010001000101010100010001010101000101000100000
0101011101010111110111011111010101010101110101010101011111010
0100000101000000000001010101000001000101010000010100000001010
0111011101011111111111110101110111111101011111111101010101010
0100000101010000010000010000010101000100010100000101010101010
0111111101010111110111010111111101011111010101111111111101010
0101010101000101000001000101000101000001000000010100000101010
0101010101110101011111111101011101110111111111110101111111110
0400000000000000000000000000000000000000000000000000000000000
