0400000000000000000000000000000000000000000000000000000000000
0111011111111111011111111111011101011101110101011111010111110
0001000000010000010001000001010101010001000101010000010100010
0101110111111101110111010101110101111111010101111111011101010
0101000000010000010001010100000000010000010101000001010001000
0101110111011101010111010111011111011111111111111101111101010
0101000001010001000001010100010000010000010000010100000001010
0101110111110101011111111111111101011111010101010101111101110
0101000000010101000001010001010001010000000101000001000001000
0101111101010101010101011101010111011111111111011101110101010
0101000001010101010100010000000100010000000100010000010101010
0101010101110101111101110101110101011101110101011101110111010
0101010100010100010000010101000101010001000001010001000101010
0101111101011101010101111111110101110111010111011111011101010
0100000101010001010100010000000101010100010101010001010000010
0111011101011101011101110111010111011101111101010111110111010
0001000101000101010100010100010100010001000000000001000100010
0111110111110111010101110111111111011101011101010101111111010
0101010001000100010000010100000100000001000101010101010100010
0101010111011111010111011111110101010111110111011101010101110
0000010001000100010100000100000101010001000001010001000000010
0111111101010101110101111111010101011101010101111111010101110
0001000101010100010100000100010001010001010100010100010101010
0111011111111111111111010111011101010111010111110111111111010
0000010001010101000000010100010001010001010101000100000101000
0111111101010101110101110111111111110111111101010101110101110
0101010101000101000101010100010100010100010000010101000000010
0101010101011101111111011111010101111111011111110111111111010
0000000000000000000000000000000000000000000000000000000000000
0000000000000000000000000000000000000000000000000000000000000
