1110111110
1010001000
1011111110
0000101000
1111101010
0010001010
1110101010
1000101010
1011111110
0000000000
