00000000000000000
00000000000000000
01010101110111110
01010101000001000
01110111110111010
01000101000001010
01110101011101110
01000100000101000
01110111011101010
00010001000101010
01111111110111110
00000000010100010
01010111010111010
01010001010001000
01011101111111110
01010001010100000
01110101010101010
00010100000101010
01110111010111010
00010100010100010
01010101110101010
01010100010101010
01110101110111110
00010100010100000
01111111111111010
00000101000100010
01110101011101110
00010000000101000
01111101110101110
00000100010100010
01111111111111110
01010000000100010
01010111111101010
00010000010101000
01110101110111110
01010100010101010
01010111110101010
01010100000100010
01010111011111010
01000101010001010
01011101011101010
00000001010100010
01111111010101110
00000000000000000
00000000000000000
