0000000000000000000000000000000000000000000000000000000000000
0000000000000000000000000000000000000000000000000000000000000
0011101110101111111111101011111111111111101111101011101110100
0010000010101010000010001000000000001000100000101000101000100
0011111111101010111110101111101111101011111111101111101111100
0000000010000000000010100000100000101000100010101000101000000
0010111111111111111111101011101111101011101010111110101011100
0010000000101010100010001010000000100000101000100000001010000
0011111110101010101011101110111110101110101111101111111111100
0000000010000010001000100010001010100010000000101000000010000
0011111011101010101011111111111010101110111011101011101011100
0000001010101000101010000000000010100010001010101010101010100
0011101110101110111010101110111111111111111110111110111010100
0010001000100010100000100010100010101010100000100010000010000
0011111011111111111010111111111010101010111011111011111011100
0000101010100000001010101010101000000010101010101010100010100
0010101010101111111111101010101011111110101010101010111010100
0010000000101000000010000010100000100010100010001010000000100
0011101111101011111111111010101111101110101111101011111110100
0000100010101000000010001000100000001000100010001000101000100
0010111110101011111110111110101111111011101110111110101010100
0010000000000000001010001010000000100010101010001000000010000
0011111111101111111010111011101111101110101011101111101111100
0010000000101010101010000000101000001000101000000010001000000
0010111111111010101011111010101111101010101011101111111111100
0000101000001010001010101010101000001010001010000010101000100
0011101011111011101010101011101110111011111111101110101110100
0010000010101010001010001000100010101000001010100010100000100
0010111110101010111011101011101110101011111010101110111011100
0040000000000000000000000000000000000000000000000000000000000
