0000000000000000000000000000000000000000000000000000000000000
0000000000000000000000000000000000000000000000000000000000000
0101110101010111010111011111111101011111111111110111010101110
0100010101010100010001000000010001010100000000010100010100010
0101011111110111010111111111111101010111111111011101110101010
0101010000010100010001010100010101010000010100000101000101010
0101110111111101011101010101010111111111010111110111111111110
0101000000000101000100000001010000000101010101000100010100000
0111010111011111011101010111111111010101010101110101110111110
0000010001010000000101010001000100010100010001000001010100000
0111010101011111011101011111110111110111011101011101010111110
0001010101000001000101000001010001010000000101010000000101000
0111011101010111010101011111010111011111010101111111110101110
0001000101010001010101000101010000000000010101000001000101010
0111111111111111011111110101010111010101110101111101011101010
0000000100000101000100010001000001010101010001010000000100010
0111111101111101111101111111110111011111010101010111110111010
0000000101010100010000000001010100000100000100000101000100000
0111111101010101111101111111011111111111111111111101110111110
0000000000000100010001010100010000010101000000010100000100010
0111110111110111010111010111011111010101111111010101110111010
0001000101010101010000010100010101000001000001010001010100000
0111011101011101010111110101010101111101111101011111010111110
0001000101010100000001000001010101010000000101000000000100000
0111111101010111110101011101110101011111010101111111010101110
0101010101000100000100000101000000000000010000010100010001000
0101010101010101011111111111111111010111011101010111111111110
0100010100010101000000010101000101010100010001010100000101000
0101110101111111011111110101110101111111111111010111110101110
0400000000000000000000000000000000000000000000000000000000000
