0040000000000000000000000000000000000000000000000000000000000
0010101011111111111010111111101111111111111111111110101111100
0010101010100000100010000000101000101000100000001000101000000
0011111110111011101011111110111110101011101010111011111011100
0010101010000000101000000010100000100000101010001000100010000
0010101010111110111111111111101110101011101111101011111111100
0000000000001010101010101000100010001000000000101010100010000
0010111111101011101010101110101110111010111111111010111011100
0010101000100000000010101000000010100010101000101010001000000
0010101010101111111010101011111111101011101011101111101110100
0010001010101010001000000000000000101010000000001010001010100
0011111011111010111111111111111111111111101111111010101011100
0000001000100000000000001000001010101000000000100010101000100
0011101010101111111011111010111010101110111010111010111110100
0000100010001000001000000010000010100000001010100010100010100
0011111111111010111110111111101110101111101111111010101110100
0000100000101010001010000010101000001000101000100000100010100
0011111011101010101011111110111010111011111011101010111010100
0000000000100010100000000000000010000000100000101010100000100
0010111011111011111111111111101111101111101111111110101111100
0010100000100010001010001000100000100010000000100000001000100
0011111111101010111010111110111111111110101111111011111011100
0010000000001010000000100000000010100000100010100010000000100
0010111111111110111111111011111110101111111110101110111111100
0010001000101000100010101000100000101000001010001000001010000
0010111011101011111010101011101011101011111010111111101011100
0000001010001010000000101000101000000010000000001000000000100
0011111011101010111111101011101111111110111111111111101111100
0000000000000000000000000000000000000000000000000000000000000
0000000000000000000000000000000000000000000000000000000000000
