0000000000000000000000000000000000000000000000000000000000000
0000000000000000000000000000000000000000000000000000000000000
0011101010101111111111101111101010101110101111101011111110100
0000101010101000000010000010101010100010101000001000001010100
0011101110101011101010111010111011111110101110101011101011100
0000100010100010101010100000001000000010101000101010001000000
0011111011111010111111111011111110111011111010111010111011100
0010001010000000101000100010001000001000001010100010001010000
0010111111101010101010111010111111101110101111101111111011100
0000100010001010000010001000000010000010101000000000100010000
0011101011111010101011101011111010111011101011101011101011100
0000001000100010101000101000001010101000101010001000101010000
0010111110111010101111101111111110101111101011101011111011100
0010101000001010100010100000100010000010101010001000100010000
0011101111111010111010111010101110101110101110111110111111100
0000000000101010100000001010000010100000100010001000100000100
0010111111101111101110101111111110111011111110111011111110100
0010000010000000101000100000100010001000001000001010000000000
0010111110111111111011101111101110101011101011101010111011100
0010001000001000001000100000000010101000101000101010101010000
0011101111101010111110111011101111101111111011101111101011100
0000100000000010000010001000100010000000001010000010000010000
0011111111111110111111111110101110101111111111101110101111100
0010101000000010000000000010101010100000000010000010101010000
0010101011111111111111101111111011101011111111111110111011100
0000001010001000100000101000001000001000000010101010100010100
0011111010111011111010111110101110101110101110101011111010100
0010100010100000000010101010101010100010101000001010001000000
0010101110101111111111101010111011111111111011111011101111100
0040000000000000000000000000000000000000000000000000000000000
