011111110111010
000001000100010
010111111111110
010100010101000
011101110101010
010001010001010
010111011101110
010001010101010
010111010101010
000101000000010
011101010111110
010000010100010
011101111101110
000000010000010
011111111101110
010001000100010
010111011101110
010001000101010
011101140101010
000000000000000
